
1111111111110000000000001111111111111
1222222222210000000000001222222222221
12222222222100000000000012222222222211111111111
12222222222100000000000012222222222222222222221
12222222222111111111111112222222222222222222221
12222222222222222222222222222222222222222222221
12222222222222222222222222222222222222222222221
12222222222222222222222222222222222222222222221
12222222222222222222222222222222222222222222221
12222222222222222222222222222222222211112222221
12222222222222222222222222222222222210012222221
12222222222222222222222222222222222210012222221
11111111111111111111111111111111111110012222221
00000000000000000000000000000000000000012222221
00000000000000000000000000000000000000012222221
00000000000000000000000000000000000000012222221
00000000000000000000000000000000000000012222221
00000000000000000000000000000000000000012222221
00000000000001111111111111111111111111112222221
00000000000001222222222222222222222222222222221
00000000000001222222222222222222222222222222221
00000000000001222222222222222222222222222222221
00000000000001222222222222222222222222222222221
00000000000001222222222222222222222222222222221
00000000000001222222222222222222222222222222221
00000000000001222222222222221111111111111111111
0000000000000122222222222221
000000000000012222222222221
00000000000001111111111111