11111111111111111111111111111111111111111111111111111111111111111111
12222222222222222222222222222222222222222222222222222222222222222221
12222222222222222222222222222222222222222222222222222222222222222221
12222222222222222222222222222222222222222222222222222222222222222221
12222222222222222222222222222222222222222222222222222222222222222221
12222222222222222222222222222222222222222222222222222222222222222221
12222222222222222222222222222222222222222222222222222222222222222221
12222222222222222222222222222222222222222222222222222222222222222221
12222222222222222222222222222222222222222222222222222222222222222221
12222222222222222222222222222222222222222222222222222222222222222221
12222222222222222222222222222222222222222222222222222222222222222221
11111111111111111111112222222211111111111111111111111111111111111111
00000000000000000000012222222210000000000000000000000000000000000000
00000000000000000000012222222210000000000000000000000000000000000000
00000000000000000000012222222210000000000000000000000000000000000000
00000000000000000000012222222210000000000000000000000000000000000000
00000000000000000000011111111110000000000000000000000000000000000000